%%%%%%%%%%%%%%%%%%%
%G.       G   ....%
%.% % %%%%%% %.%%.%
%.% % %    % %. %.%
%.%%%.%  %%% %..%.%
%.....  P    %..% %
%%%%%%%%%%%%%%%%%%%%
