%%%%
% G%
%G.%
%  %
%P %
%%%%
